!@!!!!!@!!@!!!!!@!
!@@@@@@@!!@@@@@@@!
!@!!!!!!!!!!!!##@!
!@!!!!!!!!!!!!!!@!
!@!!!!!$!!!!!!!!@!
!@%%%%%$%%%%!!!!@!
!$####!$********$!
!$!!!!!$********$!
!$!!!!!$********$!
!$%%%%%$********$!
!$!!####!!!!!!!!$!
!$!!!!!!!!!!!!!!$!
!$!!!!!!!!!!****$!
!$$$%%%%$$$$****$!
!@!!!!####!!****@!
!@!!!!!!!!!!****@!
!@!!!!!!!!!!####@!
!@!!!!!!!!!!!!!!@!
!@!!!!!!!!!!!!!!@!
!@%#%%%#%%%%%%%%@!
!@!!!!!!!!!!!!!!@!
!@!!!!!!!!!!!!!!@!
!@!!!!!!!!****!!@!
!@$$$$$$$$****%%@!
!@!!!!####****!!@!
!@!!!!!!!!****!!@!
!@!!!!!!!!!!!!!!@!
!@%%!!!&%%%%%%%%@!
!$!!****!!!!****$!
!$!!****!!!!****$!
!$****##!!****##$!
!$****!!!!****!!$!
!$@@@@@@**@@@@@@$!
!$!!!!!@**@!!!!!$!
!$!!!!!@**@!!!!!$!
!$!!!!!@**@!!!!!$!
