!@=(+~=(&&&&&&&&@!
!@!!############@!
!@!!############@!
!@!!!!!!!!))))##@!
!@********))))+~@!
!@!!!!$$$$))))##@!
!@!!!!%%%%))))##@!
!@##############@!
!@+~###;+~+~+~+~@!
!*!!))))##!!))))*!
!*!!))))##!!))))*!
!*))))$$##))))$$*!
!*))))%%##))))%%*!
!*@@@@@@))@@@@@@*!
!*!!!!!@))@!!!!!*!
!*!!!!!@))@!!!!!*!
!*!!!!!@))@!!!!!*!