!@!!!!!@##@!!!!!@!
!@@@@@@@##@@@@@@@!
!@!!!!!!##!!!!$$@!
!@!!!!!!##!!!!%%@!
!@!!!!!*########@!
!@&&&&=*+~+~####@!
!*$$$$!*))))))))*!
!*%%%%!*))))))))*!
!*!!!!!*))))))))*!
!*&&&&=*))))))))*!
!*!!$$$$!!######*!
!*!!%%%%!!######*!
!*!!!!!!!!##))))*!
!***&&&&****))))*!
!@!!!!$$$$##))))@!
!@!!!!%%%%##))))@!
!@!!########$$$$@!
!@!!########%%%%@!
!@!!##!!!!!!!!!!@!
!@=(+~=(&&&&&&&&@!
!@!!############@!
!@!!############@!
!@!!!!!!!!))))##@!
!@********))))+~@!
!@!!!!$$$$))))##@!
!@!!!!%%%%))))##@!
!@##############@!
!@+~###;+~+~+~+~@!
!*!!))))##!!))))*!
!*!!))))##!!))))*!
!*))))$$##))))$$*!
!*))))%%##))))%%*!
!*@@@@@@))@@@@@@*!
!*!!!!!@))@!!!!!*!
!*!!!!!@))@!!!!!*!
!*!!!!!@))@!!!!!*!